##############################################################################
#                                                                            #
#                                                                            #
#                                                                            #
#                    o                               %                       #
##############################################################################